111111111111111111111111111111
1P100000000000100000001C000011
101110101111101110111011101011
1000101000100010001C1000101E11
111011111010111011101110101111
101000000010101000100000100011
101111111110101010111011101011
10001C000010100010001000101011
101011111010101111101110111011
101010000010100000100010000011
101010111010111110111011111011
1010001C001010001C100010100011
101111111110101011101110101111
100000000000001000001C00000011
111111111111111111111111111111
111111111111111111111111111111
