111111111111111111111111111111
1P1C00100000000000100010000011
1C1110101011111110101010101011
10100010101C000010001010101011
101011101011101011111010101011
10101000100010100000101C101011
101010111110101111101011101011
101000100010100000100010001E11
101111101010111110111110111111
100000101000100C10100000000011
111110101111101110111111111011
100000101000001000100000001011
101111101010111011101111101011
100000001C10000000001C00000011
111111111111111111111111111111
111111111111111111111111111111
