1111111
1P1C001
1010101
1000101
11111E1
