111111111111111111111111111111
1P0000000010000000000000000001
101111101101111111111111111101
1000001010010000000000000000C1
101110101111011111111111111101
100010100000000000000001000001
111010111111111111110101011101
1C0010000000000000010001010001
101111111111101111101111101101
100000000001001000000001000001
101111111101001011111101111101
1C00000000000101000000100000C1
101111111111111011111101111101
1000000000000000100000000000E1
101111111111111111111111111111
111111111111111111111111111111
