111111111111111111111111111111
1P000000001C000000100010000011
111111111011101110101010101011
100000001000001C10101000101011
101110101111111010101111101011
100C10101000000010100000101011
111110101011111010111011101011
100000101000100010001010001011
101111101110101011101010111011
100010000E10101010001C10001011
111011111110101010111111101011
100010001000101C101C0000101011
101110101011101110111010101011
100000100000100000000010001C11
111111111111111111111111111111
111111111111111111111111111111
