111111111111111111111111111111
1P1C10000000100000000000000011
101010111010111111101011111011
1010001000100000001C1000001011
101011101111111110111011101011
101000100010001010001000101E11
101011111010101011101111101111
101010001000101000100000100011
101110101011101011111110111011
100010101010001000000C10100011
111010101110111010111110101011
1C1000100010101010001000101011
101111111010101011101011101011
100000000000100000100000001011
111111111111111111111111111111
111111111111111111111111111111
