11111111111111
1P1C111111100E
10101000001011
10001011101011
1011101C001001
10111011111101
10000000000001
11111111111111
