1111111
10010E1
1P00001
10010C1
1111111
