111111111111111111111111111111
1P0000000010000000000000001C11
111111111010111111101111101011
10000000101000100000100C100011
101111101011101011111011111011
1010001010001C1010000000100011
101010101110111010111110101111
101010001C100010100E1000100011
101011111011101011111011111011
1010001C0000101000001000000011
101110111110101011101011111111
10001000000010101000101C000011
101011111111101110111011101011
101000000000000000100000001011
111111111111111111111111111111
111111111111111111111111111111
